date,pubDate,totalDosesCumulative,initialDosesCumulative,initialDosesCumulativeBioNTech,initialDosesCumulativeModerna,initialDosesCumulativeAstraZeneca,finalDosesCumulative,finalDosesCumulativeBioNTech,finalDosesCumulativeModerna,finalDosesCumulativeAstraZeneca,finalDosesCumulativeJohnsonAndJohnson,onlyPartiallyVaccinatedCumulative,onlyPartiallyVaccinatedPercent,onlyPartiallyVaccinatedCumulativeBioNTech,onlyPartiallyVaccinatedCumulativeModerna,onlyPartiallyVaccinatedCumulativeAstraZeneca,atLeastPartiallyVaccinatedCumulative,atLeastPartiallyVaccinatedPercent,atLeastPartiallyVaccinatedCumulativeBioNTech,atLeastPartiallyVaccinatedCumulativeModerna,atLeastPartiallyVaccinatedCumulativeAstraZeneca,atLeastPartiallyVaccinatedCumulativeJohnsonAndJohnson,fullyVaccinatedCumulative,fullyVaccinatedPercent,fullyVaccinatedCumulativeBioNTech,fullyVaccinatedCumulativeModerna,fullyVaccinatedCumulativeAstraZeneca,fullyVaccinatedCumulativeJohnsonAndJohnson
2020-12-26,2020-12-27,0,0,0,0,0,0,0,0,0,0,0,0,0,0,0,0,0,0,0,0,0,0,0,0,0,0,0
2020-12-27,2020-12-28,21566,21566,21566,0,0,0,0,0,0,0,21566,0.025931048301284874,21566,0,0,21566,0.025931048301284874,21566,0,0,0,0,0,0,0,0,0
2020-12-29,2020-12-29,41962,41962,41962,0,0,0,0,0,0,0,41962,0.05045528372523954,41962,0,0,41962,0.05045528372523954,41962,0,0,0,0,0,0,0,0,0
2020-12-30,2020-12-31,131626,131626,131626,0,0,0,0,0,0,0,131626,0.15826765110381724,131626,0,0,131626,0.15826765110381724,131626,0,0,0,0,0,0,0,0,0
2020-12-31,2021-01-01,165575,165575,165575,0,0,0,0,0,0,0,165575,0.19908807022559782,165575,0,0,165575,0.19908807022559782,165575,0,0,0,0,0,0,0,0,0
2021-01-01,2021-01-02,188553,188553,188553,0,0,0,0,0,0,0,188553,0.22671691321302823,188553,0,0,188553,0.22671691321302823,188553,0,0,0,0,0,0,0,0,0
2021-01-02,2021-01-03,238809,238809,238809,0,0,0,0,0,0,0,238809,0.28714493711311967,238809,0,0,238809,0.28714493711311967,238809,0,0,0,0,0,0,0,0,0
2021-01-03,2021-01-04,265986,265986,265986,0,0,0,0,0,0,0,265986,0.3198226752047463,265986,0,0,265986,0.3198226752047463,265986,0,0,0,0,0,0,0,0,0
2021-01-04,2021-01-05,316962,316962,316962,0,0,0,0,0,0,0,316962,0.3811164301062717,316962,0,0,316962,0.3811164301062717,316962,0,0,0,0,0,0,0,0,0
2021-01-05,2021-01-06,367331,367331,367331,0,0,0,0,0,0,0,367331,0.4416803256774216,367331,0,0,367331,0.4416803256774216,367331,0,0,0,0,0,0,0,0,0
2021-01-06,2021-01-07,417060,417060,417060,0,0,0,0,0,0,0,417060,0.5014746825806301,417060,0,0,417060,0.5014746825806301,417060,0,0,0,0,0,0,0,0,0
2021-01-07,2021-01-08,476959,476959,476959,0,0,0,0,0,0,0,476959,0.5734974898790937,476959,0,0,476959,0.5734974898790937,476959,0,0,0,0,0,0,0,0,0
2021-01-08,2021-01-09,532878,532878,532878,0,0,0,0,0,0,0,532878,0.640734728586297,532878,0,0,532878,0.640734728586297,532878,0,0,0,0,0,0,0,0,0
2021-01-10,2021-01-11,613347,613347,613347,0,0,0,0,0,0,0,613347,0.7374909896340616,613347,0,0,613347,0.7374909896340616,613347,0,0,0,0,0,0,0,0,0
2021-01-11,2021-01-12,688782,688782,688782,0,0,0,0,0,0,0,688782,0.8281943480968005,688782,0,0,688782,0.8281943480968005,688782,0,0,0,0,0,0,0,0,0
2021-01-12,2021-01-13,758093,758093,758093,0,0,0,0,0,0,0,758093,0.9115341834306758,758093,0,0,758093,0.9115341834306758,758093,0,0,0,0,0,0,0,0,0
2021-01-13,2021-01-14,842455,842455,842455,0,0,0,0,0,0,0,842455,1.012971403907027,842455,0,0,842455,1.012971403907027,842455,0,0,0,0,0,0,0,0,0
2021-01-14,2021-01-15,961682,961682,961682,0,0,0,0,0,0,0,961682,1.1563304457236503,961682,0,0,961682,1.1563304457236503,961682,0,0,0,0,0,0,0,0,0
2021-01-15,2021-01-16,1048160,1048160,1048160,0,0,0,0,0,0,0,1048160,1.2603119534208826,1048160,0,0,1048160,1.2603119534208826,1048160,0,0,0,0,0,0,0,0,0
2021-01-17,2021-01-18,1145878,1139297,1136573,2724,0,6581,6581,0,0,0,1132716,1.3619824403059537,1129992,2724,0,1139297,1.3698954621398938,1136573,2724,0,0,6581,0.007913021833940265,6581,0,0,0
2021-01-18,2021-01-19,1220284,1195543,1183213,12330,0,24741,24741,0,0,0,1170802,1.4077772054734736,1158472,12330,0,1195543,1.4375258870102487,1183213,12330,0,0,24741,0.029748681536774974,24741,0,0,0
2021-01-19,2021-01-20,1297430,1254760,1239546,15214,0,42670,42670,0,0,0,1212090,1.4574220687890376,1196876,15214,0,1254760,1.508728654665687,1239546,15214,0,0,42670,0.05130658587664961,42670,0,0,0
2021-01-20,2021-01-21,1401693,1324091,1307763,16328,0,77602,77602,0,0,0,1246489,1.4987835697867142,1230161,16328,0,1324091,1.5920925380829356,1307763,16328,0,0,77602,0.0933089682962213,77602,0,0,0
2021-01-21,2021-01-22,1501639,1386464,1368374,18090,0,115175,115175,0,0,0,1271289,1.5286031931694402,1253199,18090,0,1386464,1.6670900932946597,1368374,18090,0,0,115175,0.13848690012521958,115175,0,0,0
2021-01-22,2021-01-23,1632777,1469353,1451061,19651,0,163424,163424,0,0,0,1305929,1.5702544735717634,1287637,19651,0,1469353,1.7667561724305774,1451061,19651,0,0,163424,0.19650169885881386,163424,0,0,0
2021-01-24,2021-01-25,1783118,1554355,1535804,20351,0,228763,228763,0,0,0,1325592,1.5938973467400919,1307041,20351,0,1554355,1.8689629315748701,1535804,20351,0,0,228763,0.27506558483477844,228763,0,0,0
2021-01-25,2021-01-26,1921689,1638425,1608114,30311,0,283264,283264,0,0,0,1355161,1.629451235603149,1324850,30311,0,1638425,1.9700490500339733,1608114,30311,0,0,283264,0.3405978144308244,283264,0,0,0
2021-01-26,2021-01-27,1990889,1672215,1648554,23661,0,318674,318674,0,0,0,1353541,1.6275033408499224,1329880,23661,0,1672215,2.0106782868929374,1648554,23661,0,0,318674,0.3831749460430147,318674,0,0,0
2021-01-27,2021-01-28,2104317,1738236,1712717,25519,0,366081,366081,0,0,0,1372155,1.649884892045328,1346636,25519,0,1738236,2.090062212511927,1712717,25519,0,0,366081,0.4401773204665987,366081,0,0,0
2021-01-28,2021-01-29,2216127,1799481,1767170,32311,0,416646,416646,0,0,0,1382835,1.6627265685665988,1350524,32311,0,1799481,2.1637034558214046,1767170,32311,0,0,416646,0.5009768872548056,416646,0,0,0
2021-01-29,2021-01-30,2317158,1855457,1821630,33827,0,461701,461701,0,0,0,1393756,1.6758580244925159,1359929,33827,0,1855457,2.231009231566221,1821630,33827,0,0,461701,0.5551512070737052,461701,0,0,0
2021-01-31,2021-02-01,2467918,1935356,1900204,35152,0,532562,532562,0,0,0,1402794,1.6867253533688498,1367642,35152,0,1935356,2.3270801222378505,1900204,35152,0,0,532562,0.6403547688690009,532562,0,0,0
2021-02-01,2021-02-02,2586997,1980211,1943519,36692,0,606786,606786,0,0,0,1373425,1.6514119453395242,1336733,36692,0,1980211,2.381013961223019,1943519,36692,0,0,606786,0.7296020158834946,606786,0,0,0
2021-02-02,2021-02-03,2713210,2033561,1994802,38759,0,679649,679649,0,0,0,1353912,1.627949432796495,1315153,38759,0,2033561,2.445162223620939,1994802,38759,0,0,679649,0.8172127908244441,679649,0,0,0
2021-02-03,2021-02-04,2848022,2091689,2049011,42678,0,756333,756305,28,0,0,1335356,1.6056376210428713,1292706,42650,0,2091689,2.5150555731367086,2049011,42678,0,0,756333,0.9094179520938371,756305,28,0,0
2021-02-04,2021-02-05,2987398,2153000,2105968,47032,0,834398,834389,9,0,0,1318602,1.5854925416011703,1271579,47023,0,2153000,2.588776175121317,2105968,47032,0,0,834398,1.0032836335201472,834389,9,0,0
2021-02-05,2021-02-06,3116122,2212851,2160072,52779,0,903271,903263,8,0,0,1309580,1.574644451191535,1256809,52771,0,2212851,2.6607412670196853,2160072,52779,0,0,903271,1.0860968158281503,903263,8,0,0
2021-02-07,2021-02-08,3277135,2295221,2235333,59888,0,981914,981904,10,0,0,1313307,1.5791258115281246,1253429,59878,0,2295221,2.7597832983920694,2235333,59888,0,0,981914,1.1806574868639448,981904,10,0,0
2021-02-08,2021-02-09,3369433,2344802,2281674,63113,15,1024631,1024321,310,0,0,1320171,1.587379113741795,1257353,62803,15,2344802,2.8193996994783164,2281674,63113,15,0,1024631,1.2320205857365214,1024321,310,0,0
2021-02-09,2021-02-10,3509660,2405156,2338076,67037,43,1104504,1104194,300,0,0,1300652,1.5639093867737537,1233882,66737,43,2405156,2.8919696006735194,2338076,67037,43,0,1104504,1.3280602138997657,1104194,300,0,0
2021-02-10,2021-02-11,3669148,2490423,2413319,71107,5997,1178725,1177693,1032,0,0,1311698,1.5771911432207533,1235626,70075,5997,2490423,2.9944949969225068,2413319,71107,5997,0,1178725,1.4173038537017533,1177693,1032,0,0
2021-02-11,2021-02-12,3810003,2556697,2465249,73617,17831,1253306,1249597,3709,0,0,1303391,1.5672027717917087,1215652,69908,17831,2556697,3.074183130796167,2465249,73617,17831,0,1253306,1.506980359004458,1249597,3709,0,0
2021-02-12,2021-02-13,3967246,2635673,2526472,77916,31285,1331573,1322522,9051,0,0,1304100,1.5680552763472875,1203950,68865,31285,2635673,3.1691442024201244,2526472,77916,31285,0,1331573,1.601088926072837,1322522,9051,0,0
2021-02-14,2021-02-15,4146348,2736109,2604659,81284,50166,1410239,1398445,11794,0,0,1325870,1.5942316150989788,1206214,69490,50166,2736109,3.2899088675034895,2604659,81284,50166,0,1410239,1.6956772524045107,1398445,11794,0,0
2021-02-15,2021-02-16,4284554,2813732,2665276,83587,64869,1470822,1457608,13214,0,0,1342910,1.6147205821329162,1207668,70373,64869,2813732,3.3832430862872527,2665276,83587,64869,0,1470822,1.7685225041543364,1457608,13214,0,0
2021-02-16,2021-02-17,4422007,2896064,2723359,85172,87533,1525943,1511144,14799,0,0,1370121,1.6474392019662771,1212215,70373,87533,2896064,3.482239426301228,2723359,85172,87533,0,1525943,1.8348002243349506,1511144,14799,0,0
2021-02-17,2021-02-18,4572420,2991792,2794969,90237,106586,1580628,1564342,16286,0,0,1411164,1.6967894762605196,1230627,73951,106586,2991792,3.5973431725585496,2794969,90237,106586,0,1580628,1.9005536962980296,1564342,16286,0,0
2021-02-18,2021-02-19,4719900,3085114,2860811,95282,129021,1634786,1616499,18287,0,0,1450328,1.7438804331218534,1244312,76995,129021,3085114,3.7095539343860793,2860811,95282,129021,0,1634786,1.9656735012642257,1616499,18287,0,0
2021-02-19,2021-02-20,4869641,3179290,2926650,101751,150889,1690351,1669127,21224,0,0,1488939,1.7903064604779189,1257523,80527,150889,3179290,3.8227915493736426,2926650,101751,150889,0,1690351,2.0324850888957244,1669127,21224,0,0
2021-02-21,2021-02-22,5068829,3312351,3016589,108742,187020,1756478,1732866,23612,0,0,1555873,1.8707881811028935,1283723,85130,187020,3312351,3.982784650459485,3016589,108742,187020,0,1756478,2.1119964693565914,1732866,23612,0,0
2021-02-22,2021-02-23,5220336,3413730,3087374,114470,211886,1806606,1779838,26768,0,0,1607124,1.9324125971508,1307536,87702,211886,3413730,4.104683182673894,3087374,114470,211886,0,1806606,2.1722705855230946,1779838,26768,0,0
2021-02-23,2021-02-24,5373222,3518294,3160936,118802,238556,1854928,1826159,28769,0,0,1663366,2.0000382124044798,1334777,90033,238556,3518294,4.230411372165481,3160936,118802,238556,0,1854928,2.230373159761001,1826159,28769,0,0
2021-02-24,2021-02-25,5544145,3633282,3237993,124303,270986,1910863,1880088,30775,0,0,1722419,2.0710437857762587,1357905,93528,270986,3633282,4.368673422711161,3237993,124303,270986,0,1910863,2.297629636934903,1880088,30775,0,0
2021-02-25,2021-02-26,5730949,3759906,3316427,128911,314568,1971043,1938768,32275,0,0,1788863,2.1509363283585903,1377659,96636,314568,3759906,4.52092664816335,3316427,128911,314568,0,1971043,2.369990319804759,1938768,32275,0,0
2021-02-26,2021-02-27,5910537,3881490,3383521,134324,363645,2029047,1995182,33865,0,0,1852443,2.2273851854018853,1388339,100459,363645,3881490,4.6671197566055005,3383521,134324,363645,0,2029047,2.439734571203615,1995182,33865,0,0
2021-02-28,2021-03-01,6174362,4079107,3483481,141017,454609,2095255,2060291,34964,0,0,1983852,2.3853919148011036,1423190,106053,454609,4079107,4.904735261203248,3483481,141017,454609,0,2095255,2.519343346402144,2060291,34964,0,0
2021-03-01,2021-03-02,6394364,4234952,3573626,146900,514426,2159412,2122467,36945,0,0,2075540,2.4956379482170457,1451159,109955,514426,4234952,5.0921239388678,3573626,146900,514426,0,2159412,2.5964859906507547,2122467,36945,0,0
2021-03-02,2021-03-03,6604578,4389074,3661540,153116,574418,2215504,2176609,38895,0,0,2173570,2.6135096288706188,1484931,114221,574418,4389074,5.277440874149755,3661540,153116,574418,0,2215504,2.663931245279136,2176609,38895,0,0
2021-03-03,2021-03-04,6808796,4538010,3748478,159073,630459,2270786,2228332,42454,0,0,2267224,2.7261195888821432,1520146,116619,630459,4538010,5.456522141413047,3748478,159073,630459,0,2270786,2.730402552530904,2228332,42454,0,0
2021-03-04,2021-03-05,7082562,4736174,3846276,169055,720843,2346388,2300210,46178,0,0,2389786,2.8734886486012416,1546066,122877,720843,4736174,5.69479536109105,3846276,169055,720843,0,2346388,2.821306712489809,2300210,46178,0,0
2021-03-05,2021-03-06,7326098,4915868,3931076,176113,808679,2410230,2358874,51356,0,0,2505638,3.0127895763486423,1572202,124757,808679,4915868,5.910860175773934,3931076,176113,808679,0,2410230,2.8980705994252918,2358874,51356,0,0
2021-03-07,2021-03-08,7654623,5170215,4042665,185461,942089,2484408,2428767,55641,0,0,2685807,3.22942553301164,1613898,129820,942089,5170215,6.216688068859667,4042665,185461,942089,0,2484408,2.987262535848027,2428767,55641,0,0
2021-03-08,2021-03-09,7897100,5350408,4130421,193059,1026928,2546692,2487192,59500,0,0,2803716,3.371199806133971,1643229,133559,1026928,5350408,6.433352883222712,4130421,193059,1026928,0,2546692,3.06215307708874,2487192,59500,0,0
2021-03-09,2021-03-10,8161238,5555420,4225832,202099,1127489,2605818,2543052,62766,0,0,2949602,3.5466137406828557,1682780,139333,1127489,5555420,6.679860166647687,4225832,202099,1127489,0,2605818,3.1332464259648307,2543052,62766,0,0
2021-03-10,2021-03-11,8431264,5756572,4318448,209333,1228791,2674692,2608394,66298,0,0,3081880,3.705665359304638,1710054,143035,1228791,5756572,6.921726169981642,4318448,209333,1228791,0,2674692,3.216060810677003,2608394,66298,0,0
2021-03-11,2021-03-12,8716654,5978551,4414100,218287,1346164,2738103,2668219,69752,132,0,3240448,3.896328183520447,1745881,148535,1346032,5978551,7.188634644936241,4414100,218287,1346164,0,2738103,3.292306461415794,2668219,69752,132,0
2021-03-12,2021-03-13,8863270,6113484,4413935,228311,1471238,2749786,2679147,70477,162,0,3363698,4.044524497307583,1734788,157834,1471076,6113484,7.350878646625812,4413935,228311,1471238,0,2749786,3.3063541493182287,2679147,70477,162,0
2021-03-14,2021-03-15,9399110,6507159,4619944,239705,1647510,2891951,2817279,74455,217,0,3615208,4.346941169766831,1802665,165250,1647293,6507159,7.824235107722368,4619944,239705,1647510,0,2891951,3.4772939379555363,2817279,74455,217,0
2021-03-15,2021-03-16,9663887,6712195,4712485,251147,1748563,2951692,2874977,76465,250,0,3760503,4.5216444834520395,1837508,174682,1748313,6712195,8.07077124884739,4712485,251147,1748563,0,2951692,3.5491267653953518,2874977,76465,250,0
2021-03-16,2021-03-17,9853966,6835216,4812825,259690,1762701,3018750,2940023,78474,253,0,3816466,4.588934627942663,1872802,181216,1762448,6835216,8.218692212079903,4812825,259690,1762701,0,3018750,3.6297575841372396,2940023,78474,253,0
2021-03-17,2021-03-18,10067955,6970861,4920532,271467,1778862,3097094,3013951,82886,257,0,3873767,4.657833589210952,1906581,188581,1778605,6970861,8.381792325537559,4920532,271467,1778862,0,3097094,3.7239587363266056,3013951,82886,257,0
2021-03-18,2021-03-19,10261545,7089012,5024199,283902,1780911,3172533,3085114,87162,257,0,3916479,4.709190676062685,1939085,196740,1780654,7089012,8.523857580468706,5024199,283902,1780911,0,3172533,3.814666904406019,3085114,87162,257,0
2021-03-19,2021-03-20,10473852,7227867,5123520,296629,1807718,3245985,3153156,92560,269,0,3981882,4.787831515905444,1970364,204069,1807449,7227867,8.690817411307753,5123520,296629,1807718,0,3245985,3.9029858954023084,3153156,92560,269,0
2021-03-21,2021-03-22,10862288,7517073,5282199,313349,1921525,3345215,3245935,98928,352,0,4171858,5.016259450250474,2036264,214421,1921173,7517073,9.038559911308745,5282199,313349,1921525,0,3345215,4.022300461058272,3245935,98928,352,0
2021-03-22,2021-03-23,11108978,7692386,5373863,326235,1992288,3416592,3310941,105250,401,0,4275794,5.141232529924142,2062922,220985,1991887,7692386,9.249356993328737,5373863,326235,1992288,0,3416592,4.108124463404595,3310941,105250,401,0
2021-03-23,2021-03-24,11447546,7930580,5500599,342301,2087680,3516966,3407198,109318,450,0,4413614,5.306947872448629,2093401,232983,2087230,7930580,9.535762451878133,5500599,342301,2087680,0,3516966,4.2288145794295025,3407198,109318,450,0
2021-03-24,2021-03-25,11746915,8143296,5611264,357362,2174670,3603619,3489123,113969,527,0,4539677,5.4585265491622,2122141,243393,2174143,8143296,9.79153305701845,5611264,357362,2174670,0,3603619,4.3330065078562505,3489123,113969,527,0
2021-03-25,2021-03-26,12040271,8357237,5719396,374424,2263417,3683034,3563405,119062,567,0,4674203,5.620281172355127,2155991,255362,2262850,8357237,10.048776607265374,5719396,374424,2263417,0,3683034,4.428495434910249,3563405,119062,567,0
2021-03-26,2021-03-27,12363439,8595379,5827600,391256,2376523,3768060,3643462,123953,645,0,4827319,5.8043884890434105,2184138,267303,2375878,8595379,10.335119540798,5827600,391256,2376523,0,3768060,4.53073105175459,3643462,123953,645,0
2021-03-28,2021-03-29,12872859,8994965,5963495,436451,2595019,3877894,3741252,135900,742,0,5117071,6.15278750172049,2222243,300551,2594277,8994965,10.815583412935496,5963495,436451,2595019,0,3877894,4.662795911215005,3741252,135900,742,0
2021-03-29,2021-03-30,13170672,9209527,6059246,459392,2690889,3961145,3818075,142303,767,0,5248382,6.31067639551118,2241171,317089,2690122,9209527,11.073573656171156,6059246,459392,2690889,0,3961145,4.762897260659978,3818075,142303,767,0
2021-03-30,2021-03-31,13481171,9421702,6147152,477701,2796849,4059469,3907736,149735,1998,0,5362233,6.447571312517096,2239416,327966,2794851,9421702,11.328693760656233,6147152,477701,2796849,0,4059469,4.881122448139136,3907736,149735,1998,0
2021-03-31,2021-04-01,13772656,9620262,6279968,499299,2840995,4152394,3993266,157131,1997,0,5467868,6.574587276873316,2286702,342168,2838998,9620262,11.567443132385023,6279968,499299,2840995,0,4152394,4.992855855511708,3993266,157131,1997,0
2021-04-02,2021-04-03,14374088,10039938,6562591,540876,2936471,4334150,4160285,171801,2064,0,5705788,6.860663276680498,2402306,369075,2934407,10039938,12.072063304270863,6562591,540876,2936471,0,4334150,5.211400027590366,4160285,171801,2064,0
2021-04-05,2021-04-06,15075064,10540309,6857330,580218,3102761,4534755,4340796,191782,2177,0,6005554,7.221103164702522,2516534,388436,3100584,10540309,12.673711480546585,6857330,580218,3102761,0,4534755,5.4526083158440635,4340796,191782,2177,0
2021-04-06,2021-04-07,15427516,10793677,7002239,606022,3185416,4633839,4432152,199429,2258,0,6159838,7.406614889459798,2570087,406593,3183158,10793677,12.978362219951201,7002239,606022,3185416,0,4633839,5.5717473304914025,4432152,199429,2258,0
2021-04-07,2021-04-08,16253541,11515936,7509009,642187,3364740,4737605,4528510,206707,2388,0,6778331,8.150293450945775,2980499,435480,3362352,11515936,13.846809452402177,7509009,642187,3364740,0,4737605,5.6965160014564,4528510,206707,2388,0
2021-04-08,2021-04-09,17035698,12204176,8032471,669924,3501781,4831522,4612900,216160,2462,0,7372654,8.864909903675281,3419571,453764,3499319,12204176,14.674352097439563,8032471,669924,3501781,0,4831522,5.809442193764282,4612900,216160,2462,0
2021-04-09,2021-04-10,17580596,12670288,8394343,691720,3584225,4910308,4682613,225134,2561,0,7759980,9.330632300705027,3711730,466586,3581664,12670288,15.23480710930122,8394343,691720,3584225,0,4910308,5.904174808596195,4682613,225134,2561,0
2021-04-11,2021-04-12,18231747,13196552,8710965,722451,3763136,5035195,4796603,235917,2675,0,8161357,9.813249678708589,3914362,486534,3760461,13196552,15.867589136716012,8710965,722451,3763136,0,5035195,6.054339458007423,4796603,235917,2675,0
2021-04-12,2021-04-13,18684873,13567817,8935533,750156,3882128,5117056,4868757,245578,2721,0,8450761,10.161230254734974,4066776,504578,3879407,13567817,16.313999720392935,8935533,750156,3882128,0,5117056,6.15276946565796,4868757,245578,2721,0
2021-04-13,2021-04-14,19244464,14058329,9289499,776123,3992707,5186135,4932303,250913,2919,0,8872194,10.667963050745147,4357196,525210,3989788,14058329,16.903793393969853,9289499,776123,3992707,0,5186135,6.235830343224706,4932303,250913,2919,0
2021-04-14,2021-04-15,20049936,14773908,9840593,803698,4129617,5276028,5013881,258724,3423,0,9497880,11.420290505416283,4826712,544974,4126194,14773908,17.76420856657419,9840593,803698,4129617,0,5276028,6.343918061157908,5013881,258724,3423,0
2021-04-15,2021-04-16,20744105,15393858,10319684,831098,4243076,5350247,5077262,268832,4153,0,10043611,12.076479734782346,5242422,562266,4238923,15393858,18.509639030933904,10319684,831098,4243076,0,5350247,6.433159296151558,5077262,268832,4153,0
2021-04-16,2021-04-17,21332342,15906352,10687042,852964,4366346,5425990,5144025,277323,4642,0,10480362,12.601630957848025,5543017,575641,4361704,15906352,19.125863952946272,10687042,852964,4366346,0,5425990,6.524232995098243,5144025,277323,4642,0
2021-04-18,2021-04-19,21945707,16428425,10992320,876543,4559562,5517282,5223357,286913,7012,0,10911143,13.119603828026818,5768963,589630,4552550,16428425,19.753606704490213,10992320,876543,4559562,0,5517282,6.634002876463397,5223357,286913,7012,0
2021-04-19,2021-04-20,22378776,16795784,11248051,908286,4639447,5582992,5278575,296075,8342,0,11212792,13.482307843098424,5969476,612211,4631105,16795784,20.195320697484355,11248051,908286,4639447,0,5582992,6.713012854385933,5278575,296075,8342,0
2021-04-20,2021-04-21,22935592,17288804,11571347,939534,4777923,5646788,5333723,302854,10211,0,11642016,13.998408569986614,6237624,636680,4767712,17288804,20.788130000716272,11571347,939534,4777923,0,5646788,6.789721430729659,5333723,302854,10211,0
2021-04-21,2021-04-22,23656941,17932380,11962969,968568,5000843,5724561,5396399,315548,12614,0,12207819,14.678732455825985,6566570,653020,4988229,17932380,21.561968465964707,11962969,968568,5000843,0,5724561,6.88323601013872,5396399,315548,12614,0
2021-04-22,2021-04-23,24286909,18496378,12289659,997621,5209098,5790531,5451814,322733,15984,0,12705847,15.277563399134541,6837845,674888,5193114,18496378,22.24012201227965,12289659,997621,5209098,0,5790531,6.962558613145108,5451814,322733,15984,0
2021-04-23,2021-04-24,24821527,18965663,12574961,1027368,5363334,5855864,5504844,331579,19441,0,13109799,15.763276967872397,7070117,695789,5343893,18965663,22.80439225256846,12574961,1027368,5363334,0,5855864,7.04111528469606,5504844,331579,19441,0
2021-04-25,2021-04-26,25446941,19486698,12918978,1069222,5498498,5960243,5582903,353756,23584,0,13526455,16.26426587916889,7336075,715466,5474914,19486698,23.430886908585336,12918978,1069222,5498498,0,5960243,7.166621029416445,5582903,353756,23584,0
2021-04-26,2021-04-27,25892613,19854550,13183715,1103099,5567736,6038063,5646701,363757,27542,63,13816550,16.61307731647582,7537014,739342,5540194,19854613,23.873269438297253,13183715,1103099,5567736,63,6038063,7.260192121821434,5646701,363757,27542,63
2021-04-27,2021-04-28,26634961,20521233,13756748,1134048,5630437,6113728,5708679,373043,31554,452,14407957,17.324187558649516,8048069,761005,5598883,20521685,24.67535959189248,13756748,1134048,5630437,452,6113728,7.351172033242964,5708679,373043,31554,452
2021-04-28,2021-04-29,27803779,21562627,14675904,1207092,5679631,6241152,5818214,385443,36484,1011,15322486,18.423821040608424,8857690,821649,5643147,21563638,25.928208222638503,14675904,1207092,5679631,1011,6241152,7.504387182030079,5818214,385443,36484,1011
2021-04-29,2021-04-30,28774580,22393183,15394941,1266702,5731540,6381397,5934726,400559,44006,2106,16013892,19.255170497243785,9460215,866143,5687534,22395289,26.928188851907347,15394941,1266702,5731540,2106,6381397,7.6730183546635615,5934726,400559,44006,2106
2021-05-02,2021-05-03,30147919,23492053,16279948,1365449,5846656,6655866,6161524,424138,63436,6768,16842955,20.25203930452414,10118424,941311,5783220,23498821,28.255080328955174,16279948,1365449,5846656,6768,6655866,8.003041024431038,6161524,424138,63436,6768
2021-05-03,2021-05-04,30623902,23852426,16515448,1435533,5901445,6771476,6252791,436993,73953,7739,17088689,20.547510890505215,10262657,998540,5827492,23860165,28.68956186087484,16515448,1435533,5901445,7739,6771476,8.142050970369622,6252791,436993,73953,7739
2021-05-04,2021-05-05,31468712,24537128,17014901,1482621,6039606,6931584,6384196,450071,87526,9791,17615335,21.180752236312436,10630705,1032550,5952080,24546919,29.515317733317602,17014901,1482621,6039606,9791,6931584,8.334565497005165,6384196,450071,87526,9791
2021-05-05,2021-05-06,32596999,25451513,17679768,1534466,6237279,7145486,6560488,469922,103645,11431,18317458,22.024987858423305,11119280,1064544,6133634,25462944,30.61675001191282,17679768,1534466,6237279,11431,7145486,8.591762153489512,6560488,469922,103645,11431
2021-05-06,2021-05-07,33565445,26205337,18186534,1600265,6418538,7360108,6733187,489373,121984,15564,18860793,22.67829612740126,11453347,1110892,6296554,26220901,31.52812066837656,18186534,1600265,6418538,15564,7360108,8.849824540975295,6733187,489373,121984,15564
2021-05-07,2021-05-08,34408840,26836612,18585457,1652547,6598608,7572228,6894872,511805,147618,17933,19282317,23.185138342190783,11690585,1140742,6450990,26854545,32.290016855421875,18585457,1652547,6598608,17933,7572228,9.104878513231093,6894872,511805,147618,17933
2021-05-09,2021-05-10,35079739,27266358,18847145,1738394,6680819,7813381,7078907,538797,175808,19869,19472846,23.41423120604108,11768238,1199597,6505011,27286227,32.80907309175663,18847145,1738394,6680819,19869,7813381,9.394841885715548,7078907,538797,175808,19869
2021-05-10,2021-05-11,35709755,27686865,19088134,1809562,6789169,8022890,7230046,565799,202796,24249,19688224,23.673202611078366,11858088,1243763,6586373,27711114,33.31995899176535,19088134,1809562,6789169,24249,8022890,9.64675638068698,7230046,565799,202796,24249
2021-05-11,2021-05-12,36837184,28516504,19701594,1870450,6944460,8320680,7467073,593411,232260,27936,20223760,24.31713332994496,12234521,1277039,6712200,28544440,34.321953648016695,19701594,1870450,6944460,27936,8320680,10.004820318071735,7467073,593411,232260,27936
2021-05-13,2021-05-14,38646171,29823801,20677716,1980398,7165687,8822370,7872537,636562,279346,33925,21035356,25.29299974361136,12805179,1343836,6886341,29857726,35.90105420905728,20677716,1980398,7165687,33925,8822370,10.608054465445917,7872537,636562,279346,33925
2021-05-14,2021-05-15,39414342,30353408,21044011,2030164,7279233,9060934,8061370,653327,306804,39433,21331907,25.649573902231147,12982641,1376837,6972429,30392841,36.54447871576886,21044011,2030164,7279233,39433,9060934,10.894904813537714,8061370,653327,306804,39433
2021-05-16,2021-05-17,40075392,30743232,21305968,2113398,7323866,9332160,8264340,678834,341248,47738,21458810,25.802162598446394,13041628,1434564,6982618,30790970,37.02319068503262,21305968,2113398,7323866,47738,9332160,11.22102808658623,8264340,678834,341248,47738
2021-05-17,2021-05-18,40642605,31094584,21501257,2173111,7420216,9548021,8417405,709076,365399,56141,21602704,25.975181343891308,13083852,1464035,7054817,31150725,37.45576159672829,21501257,2173111,7420216,56141,9548021,11.48058025283698,8417405,709076,365399,56141
2021-05-18,2021-05-19,41517849,31616223,21803316,2246741,7566166,9901626,8707850,739582,391631,62563,21777160,26.184947965538758,13095466,1507159,7174535,31678786,38.09070434443416,21803316,2246741,7566166,62563,9901626,11.905756378895397,8707850,739582,391631,62563
2021-05-19,2021-05-20,42611604,32178636,22146966,2311338,7720332,10432968,9163748,770684,418260,80276,21825944,26.24360605050259,12983218,1540654,7302072,32258912,38.788250265181226,22146966,2311338,7720332,80276,10432968,12.544644214678636,9163748,770684,418260,80276
2021-05-20,2021-05-21,43549672,32633840,22409631,2374685,7849524,10915832,9580519,801305,443763,90245,21808253,26.22233431835485,12829112,1573380,7405761,32724085,39.347576219528506,22409631,2374685,7849524,90245,10915832,13.125241901173656,9580519,801305,443763,90245
2021-05-21,2021-05-22,44385214,33041570,22634281,2430275,7977014,11343644,9941560,829444,471771,100869,21798795,26.21096197972768,12692721,1600831,7505243,33142439,39.85060681310338,22634281,2430275,7977014,100869,11343644,13.6396448333757,9941560,829444,471771,100869
2021-05-24,2021-05-25,45399574,33503002,22865794,2566223,8070985,11896572,10386390,880910,503003,126269,21732699,26.131487873796043,12479404,1685313,7567982,33629271,40.43597563933964,22865794,2566223,8070985,126269,11896572,14.304487765543596,10386390,880910,503003,126269
2021-05-25,2021-05-26,46063274,33789188,23013975,2621234,8153979,12274086,10683858,910589,527357,152282,21667384,26.052952845520128,12330117,1710645,7626622,33941470,40.811365018390596,23013975,2621234,8153979,152282,12274086,14.758412172870464,10683858,910589,527357,152282
2021-05-26,2021-05-27,47358842,34305216,23365661,2682765,8256790,13053626,11317793,940279,561191,234363,21485953,25.834799454796283,12047868,1742486,7695599,34539579,41.530533773302636,23365661,2682765,8256790,234363,13053626,15.695734318506355,11317793,940279,561191,234363
2021-05-27,2021-05-28,48385907,34711424,23624702,2733847,8352875,13674483,11789235,975608,596168,313472,21350413,25.671825593776337,11835467,1758239,7756707,35024896,42.11408095722338,23624702,2733847,8352875,313472,13674483,16.442255363447043,11789235,975608,596168,313472
2021-05-28,2021-05-29,49255748,35058647,23834712,2781721,8442214,14197101,12161590,1010338,630171,395002,21256548,25.558961926485225,11673122,1771383,7812043,35453649,42.62961535174813,23834712,2781721,8442214,395002,14197101,17.0706534252629,12161590,1010338,630171,395002
2021-05-30,2021-05-31,49940729,35325677,23990089,2846706,8488882,14615052,12465584,1053511,666227,429730,21140355,25.419250978916313,11524505,1793195,7822655,35755407,42.99245042887412,23990089,2846706,8488882,429730,14615052,17.57319944995781,12465584,1053511,666227,429730
2021-05-31,2021-06-01,50541084,35531114,24120063,2880517,8530534,15009970,12745213,1092247,699569,472941,20994085,25.24337532116666,11374850,1788270,7830965,36004055,43.29142582060267,24120063,2880517,8530534,472941,15009970,18.048050499436005,12745213,1092247,699569,472941
2021-06-01,2021-06-02,51540953,35936861,24438661,2911903,8586297,15604092,13166289,1141026,737181,559596,20892365,25.12106676913074,11272372,1770877,7849116,36496457,43.88349203805835,24438661,2911903,8586297,559596,15604092,18.76242526892761,13166289,1141026,737181,559596
2021-06-02,2021-06-03,52779769,36461594,24890949,2939086,8631559,16318175,13698210,1182246,775047,662672,20806091,25.017330551883916,11192739,1756840,7856512,37124266,44.63837219677955,24890949,2939086,8631559,662672,16318175,19.621041644895637,13698210,1182246,775047,662672
2021-06-03,2021-06-04,53404798,36695899,25073728,2968713,8653458,16708899,13978891,1214150,802342,713516,20700516,24.890386731777813,11094837,1754563,7851116,37409415,44.9812365430683,25073728,2968713,8653458,713516,16708899,20.090849811290482,13978891,1214150,802342,713516
2021-06-04,2021-06-05,54240350,36999375,25310441,2999794,8689140,17240975,14346541,1258120,845140,791174,20549574,24.708893441752195,10963900,1741674,7844000,37790549,45.439513653485704,25310441,2999794,8689140,791174,17240975,20.730620211733513,14346541,1258120,845140,791174
2021-06-06,2021-06-07,54908484,37162909,25418032,3039156,8705721,17745575,14696213,1321449,896717,831196,20248530,24.346916881202624,10721819,1717707,7809004,37994105,45.684270236441115,25418032,3039156,8705721,831196,17745575,21.33735335523849,14696213,1321449,896717,831196
2021-06-07,2021-06-08,55546616,37359430,25553053,3068627,8737750,18187186,14980831,1379787,940846,885722,20057966,24.117781933206427,10572222,1688840,7796904,38245152,45.98613019577027,25553053,3068627,8737750,885722,18187186,21.868348262563853,14980831,1379787,940846,885722
2021-06-08,2021-06-09,56597382,37671963,25805032,3095971,8770960,18925419,15557685,1427234,974534,965966,19712510,23.7024041987184,10247347,1668737,7796426,38637929,46.458406897923375,25805032,3095971,8770960,965966,18925419,22.756002699204974,15557685,1427234,974534,965966
2021-06-09,2021-06-10,57891852,38034567,26114234,3122672,8797661,19857285,16308419,1475964,1009826,1063076,19240358,23.13468666567805,9805815,1646708,7787835,39097643,47.01116892791396,26114234,3122672,8797661,1063076,19857285,23.87648226223591,16308419,1475964,1009826,1063076
2021-06-10,2021-06-11,59038531,38390070,26409579,3156060,8824431,20648461,16923135,1535896,1040330,1149100,18890709,22.714267250510844,9486444,1620164,7784101,39539170,47.54206283328915,26409579,3156060,8824431,1149100,20648461,24.827795582778307,16923135,1535896,1040330,1149100
2021-06-11,2021-06-12,60105411,38755315,26699748,3202169,8853398,21350096,17431358,1593364,1077085,1248289,18653508,22.429055779300928,9268390,1608805,7776313,40003604,48.1005002109558,26699748,3202169,8853398,1248289,21350096,25.671444431654873,17431358,1593364,1077085,1248289
2021-06-13,2021-06-14,60735326,38922897,26828759,3224393,8869745,21812429,17737280,1669366,1115673,1290110,18400578,22.124931692922186,9091479,1555027,7754072,40213007,48.35228725108535,26828759,3224393,8869745,1290110,21812429,26.22735555816317,17737280,1669366,1115673,1290110
2021-06-14,2021-06-15,61429675,39127487,26990845,3248626,8888016,22302188,18013542,1766387,1174547,1347712,18173011,21.851304183473122,8977303,1482239,7713469,40475199,48.66754800487421,26990845,3248626,8888016,1347712,22302188,26.816243821401088,18013542,1766387,1174547,1347712
2021-06-15,2021-06-16,62264554,39297028,27152605,3262194,8882229,22967526,18478173,1840244,1239121,1409988,17739490,21.330036725872205,8674432,1421950,7643108,40707016,48.94628573204007,27152605,3262194,8882229,1409988,22967526,27.616249006167866,18478173,1840244,1239121,1409988
2021-06-16,2021-06-17,63653046,39736556,27525623,3298165,8912768,23916490,19189915,1925419,1311901,1489255,17309321,20.812799727044634,8335708,1372746,7600867,41225811,49.570087002719156,27525623,3298165,8912768,1489255,23916490,28.75728727567452,19189915,1925419,1311901,1489255
2021-06-17,2021-06-18,64763343,40105774,27841243,3327953,8936578,24657569,19723589,1998329,1378522,1557129,17005334,20.447284491026704,8117654,1329624,7558056,41662903,50.09564824560635,27841243,3327953,8936578,1557129,24657569,29.64836375457964,19723589,1998329,1378522,1557129
2021-06-18,2021-06-19,65738489,40436646,28113557,3363538,8959551,25301843,20157652,2064528,1451209,1628454,16763257,20.15621009709041,7955905,1299010,7508342,42065100,50.57925159502821,28113557,3363538,8959551,1628454,25301843,30.423041497937795,20157652,2064528,1451209,1628454
2021-06-20,2021-06-21,66454623,40623120,28250232,3400793,8972095,25831503,20472529,2176477,1521033,1661464,16453081,19.783253181672652,7777703,1224316,7451062,42284584,50.843160071582005,28250232,3400793,8972095,1661464,25831503,31.059906889909357,20472529,2176477,1521033,1661464
2021-06-21,2021-06-22,67116671,40842517,28427415,3427740,8987362,26274154,20725544,2257414,1592850,1698346,16266709,19.55915871195147,7701871,1170326,7394512,42540863,51.151311009521585,28427415,3427740,8987362,1698346,26274154,31.59215229757012,20725544,2257414,1592850,1698346
2021-06-22,2021-06-23,68167982,41191063,28725538,3460320,9005205,26976919,21244272,2324623,1676219,1731805,15945949,19.173475550812633,7481266,1135697,7328986,42922868,51.610635413969895,28725538,3460320,9005205,1731805,26976919,32.43715986315727,21244272,2324623,1676219,1731805
2021-06-23,2021-06-24,69516383,41679432,29162348,3490396,9026688,27836951,21904539,2392312,1771605,1768495,15610976,18.770702619224654,7257809,1098084,7255083,43447927,52.24196854436146,29162348,3490396,9026688,1768495,27836951,33.4712659251368,21904539,2392312,1771605,1768495
2021-06-24,2021-06-25,70536404,42153323,29577875,3526659,9048789,28383081,22271657,2446143,1859816,1805465,15575707,18.728295026600247,7306218,1080516,7188973,43958788,52.856229940366404,29577875,3526659,9048789,1805465,28383081,34.127934913766154,22271657,2446143,1859816,1805465
2021-06-25,2021-06-26,71437514,42521814,29899223,3553241,9069350,28915700,22633173,2495116,1945404,1842007,15448121,18.57488508833781,7266050,1058125,7123946,44363821,53.34324330801058,29899223,3553241,9069350,1842007,28915700,34.76835821967278,22633173,2495116,1945404,1842007
2021-06-27,2021-06-28,72153878,42750540,30070309,3597733,9082498,29403338,22886226,2572857,2086171,1858084,15205286,18.282899272041668,7184083,1024876,6996327,44608624,53.63759545571064,30070309,3597733,9082498,1858084,29403338,35.35469618366896,22886226,2572857,2086171,1858084
2021-06-28,2021-06-29,72806699,43003441,30274922,3630086,9098433,29803258,23094796,2633808,2191311,1883343,15083526,18.136494540465836,7180126,996278,6907122,44886784,53.97205619926463,30274922,3630086,9098433,1883343,29803258,35.835561658798795,23094796,2633808,2191311,1883343
2021-06-29,2021-06-30,73754612,43401696,30621848,3666375,9113473,30352916,23438440,2694536,2313964,1905976,14954756,17.981660955667707,7183408,971839,6799509,45307672,54.47813368500288,30621848,3666375,9113473,1905976,30352916,36.496472729335174,23438440,2694536,2313964,1905976
2021-06-30,2021-07-01,74871502,43885374,31051466,3703520,9130388,30986128,23847174,2767532,2439767,1931655,14830901,17.832737187358532,7204292,935988,6690621,45817029,55.090586665138176,31051466,3703520,9130388,1931655,30986128,37.25784947777964,23847174,2767532,2439767,1931655
2021-07-01,2021-07-02,75781404,44293917,31475799,3731623,9086495,31487487,24165108,2813442,2553405,1955532,14761962,17.749844646375397,7310691,918181,6533090,46249449,55.61053027574939,31475799,3731623,9086495,1955532,31487487,37.86068562937399,24165108,2813442,2553405,1955532
2021-07-04,2021-07-05,77332207,44970821,32057885,3807570,9105366,32361386,24709772,2982118,2669523,1999973,14609408,17.5664130808299,7348113,825452,6435843,46970794,56.47787851079021,32057885,3807570,9105366,1999973,32361386,38.911465429960316,24709772,2982118,2669523,1999973
2021-07-05,2021-07-06,77892414,45196411,32248146,3833985,9114280,32696003,24927449,3044954,2706872,2016728,14517136,17.455464843379463,7320697,789031,6407408,47213139,56.76927514904371,32248146,3833985,9114280,2016728,32696003,39.31381030566425,24927449,3044954,2706872,2016728
2021-07-06,2021-07-07,78672892,45470371,32489931,3859350,9121090,33202521,25297575,3118313,2751734,2034899,14302749,17.197685020873315,7192356,741037,6369356,47505270,57.12053468123802,32489931,3859350,9121090,2034899,33202521,39.92284966036471,25297575,3118313,2751734,2034899
2021-07-07,2021-07-08,79729251,45819423,32802127,3888212,9129084,33909828,25849762,3205612,2801085,2053369,13962964,16.789126120425752,6952365,682600,6327999,47872792,57.56244466611166,32802127,3888212,9129084,2053369,33909828,40.7733185456859,25849762,3205612,2801085,2053369
2021-07-08,2021-07-09,80596825,46106470,33057441,3913281,9135748,34490355,26292779,3283739,2839857,2073980,13690095,16.461027297328133,6764662,629542,6295891,48180450,57.932373927832735,33057441,3913281,9135748,2073980,34490355,41.4713466305046,26292779,3283739,2839857,2073980
2021-07-11,2021-07-12,81939305,46501555,33388017,3966107,9147431,35437750,26937935,3481232,2907453,2111130,13174935,15.841596765802123,6450082,484875,6239978,48612685,58.45209509367275,33388017,3966107,9147431,2111130,35437750,42.61049832787063,26937935,3481232,2907453,2111130
2021-07-12,2021-07-13,82449122,46672885,33525199,3994879,9152807,35776237,27183021,3535392,2931073,2126751,13023399,15.65938924770032,6342178,459487,6221734,48799636,58.676885755407596,33525199,3994879,9152807,2126751,35776237,43.01749650770727,27183021,3535392,2931073,2126751
2021-07-13,2021-07-14,83212320,46861839,33684288,4021098,9156453,36350481,27654140,3587044,2963547,2145750,12657108,15.218959422358305,6030148,434054,6192906,49007589,58.92692930949259,33684288,4021098,9156453,2145750,36350481,43.70796988713429,27654140,3587044,2963547,2145750
2021-07-14,2021-07-15,84203433,47078917,33873872,4043966,9161079,37124516,28304243,3640966,3009745,2169562,12123963,14.577903651858975,5569629,403000,6151334,49248479,59.216576449680694,33873872,4043966,9161079,2169562,37124516,44.63867279782171,28304243,3640966,3009745,2169562
2021-07-15,2021-07-16,84989850,47275935,34048926,4063049,9163960,37713915,28783934,3691832,3045596,2192553,11754573,14.133747575998287,5264992,371217,6118364,49468488,59.48111618842303,34048926,4063049,9163960,2192553,37713915,45.34736861242475,28783934,3691832,3045596,2192553
2021-07-18,2021-07-19,86114976,47567061,34292452,4105554,9169055,38547915,29391066,3816379,3101423,2239047,11258193,13.536898194759681,4901386,289175,6067632,49806108,59.887071883845444,34292452,4105554,9169055,2239047,38547915,46.350173689085764,29391066,3816379,3101423,2239047
2021-07-19,2021-07-20,86520137,47676661,34386385,4119255,9171021,38843476,29614222,3854357,3120152,2254745,11087930,13.332173253791414,4772163,264898,6050869,49931406,60.037730721369996,34386385,4119255,9171021,2254745,38843476,46.705557467578586,29614222,3854357,3120152,2254745
2021-07-20,2021-07-21,87121012,47811534,34501982,4135381,9174171,39309478,30013920,3885642,3140066,2269850,10771906,12.952184678795343,4488062,249739,6034105,50081384,60.21806489377703,34501982,4135381,9174171,2269850,39309478,47.265880214981685,30013920,3885642,3140066,2269850
2021-07-21,2021-07-22,87873728,47977205,34651909,4148619,9176677,39896523,30530171,3919870,3161377,2285105,10365787,12.463865500224001,4121738,228749,6015300,50262310,60.4356110703957,34651909,4148619,9176677,2285105,39896523,47.9717455701717,30530171,3919870,3161377,2285105
